****************************
****************************
****************************
**##****##****##/*/*/*/*/*/*
**##***+##+***##************
**##****##***+##*/**********
**##***+##+***##****~~~~~~~~
**##+***##****##****~~~~~~~~
**##****##****##*/**********
**##****##***+##************
**##****##****##/*/*/*/*/*/*
****************************
****************************
****************************