***************#############
*******************#########
*******************#########
###########*********++***###
********************++******
****************************
~~~~~****~~~~~~~~~~~~~~~~~~~
~~~~~****~~~~~~~~~~~~~~~~~~~
****************************
*******************+++******
###**************###########
#########*******************
#########*******************
#############***************