*******************~~~~~~~~~
*************+++++*~~~~~~~~~
######*******+++++*~~***++**
*****///***********~~***++**
***************//**~~***++**
**//******/********~~***++**
************~~~~~~~~~*******
************~~~~~~~~~*******
****///*******//*********//*
****************************
~~*********//**///****######
~~****//********************
~~*************//***********
~~****//********************